{
  "level-1": {
    "name": "Cross Roads",
    "difficulty": "Easy",
    "grid": [
      "##############################",
      "##############################",
      "##############################",
      "##############################",
      "##############################",
      "##############################",
      "##############################",
      "##############################",
      "##############################",
      "##############################",
      "##############################",
      "##############################",
      "##############################",
      "##############################",
      "##############****************",
      "##############****************",
      "##############****************",
      "##############################",
      "##############################",
      "##############################",
      "##############################",
      "##############################",
      "##############################",
      "##############################",
      "##############################",
      "##############################",
      "##############################",
      "##############################",
      "##############################",
      "##############################"
    ]
  },
  "level-2": {
    "name": "The Maze",
    "difficulty": "Medium",
    "grid": [
      "##############################",
      "#****************************#",
      "#*####*####*####*####*####*##",
      "#*####*####*####*####*####*##",
      "#*####*####*####*####*####*##",
      "#*************************###",
      "#*####*####*####*####*####*##",
      "#*####*####*####*####*####*##",
      "#*####*####*####*####*####*##",
      "#*************************###",
      "#*####*####*####*####*####*##",
      "#*####*####*####*####*####*##",
      "#*####*####*####*####*####*##",
      "#*************************###",
      "#*####*####*####*####*####*##",
      "#*####*####*####*####*####*##",
      "#*####*####*####*####*####*##",
      "#*************************###",
      "#*####*####*####*####*####*##",
      "#*####*####*####*####*####*##",
      "#*####*####*####*####*####*##",
      "#*************************###",
      "#*####*####*####*####*####*##",
      "#*####*####*####*####*####*##",
      "#*####*####*####*####*####*##",
      "#*************************###",
      "#*####*####*####*####*####*##",
      "#*####*####*####*####*####*##",
      "#****************************#",
      "##############################"
    ]
  },
  "level-3": {
    "name": "The Arena",
    "difficulty": "Hard",
    "grid": [
      "##############################",
      "#****************************#",
      "#*##########################*#",
      "#*#************************#*#",
      "#*#*######################*#*#",
      "#*#*#********************#*#*#",
      "#*#*#*##################*#*#*#",
      "#*#*#*#****************#*#*#*#",
      "#*#*#*#*##############*#*#*#*#",
      "#*#*#*#*#************#*#*#*#*#",
      "#*#*#*#*#*##########*#*#*#*#*#",
      "#*#*#*#*#*#********#*#*#*#*#*#",
      "#*#*#*#*#*#*######*#*#*#*#*#*#",
      "#*#*#*#*#*#*#****#*#*#*#*#*#*#",
      "#*#*#*#*#*#*#*##*#*#*#*#*#*#*#",
      "#*#*#*#*#*#*#*##*#*#*#*#*#*#*#",
      "#*#*#*#*#*#*#****#*#*#*#*#*#*#",
      "#*#*#*#*#*#*######*#*#*#*#*#*#",
      "#*#*#*#*#*#********#*#*#*#*#*#",
      "#*#*#*#*#*##########*#*#*#*#*#",
      "#*#*#*#*#************#*#*#*#*#",
      "#*#*#*#*######*#*#",
      "#*#*#*#****************#*#*#*#",
      "#*#*#*##################*#*#*#",
      "#*#*#********************#*#*#",
      "#*#*######################*#*#",
      "#*#************************#*#",
      "#*##########################*#",
      "#****************************#",
      "##############################"
    ]},
    "level-4": {
   
        "name": "The Labyrinth",
        "difficulty": "Extreme",
        "grid": [
        "#########****#############",
        "#****************************#",
        "#*##########################*#",
        "#*#************************#*#",
        "#*#*######################*#*#",
        "#*#*#********************#*#*#",
        "#*#*#*################**#*#*#*#",
        "#*#*#*#******************#*#*#*",
        "#*#*#*####",
        "#*#**************************"]}}